Variable	category (group)
URXUP8	perchlorate
URXUP8CA	perchlorate
LBXWBF	volatile compounds
LBXWCF	volatile compounds
LBXWBM	volatile compounds
LBXWCM	volatile compounds
LBXWME	volatile compounds
LBXV1A	volatile compounds
LBXV1D	volatile compounds
LBXV1E	volatile compounds
LBXV2A	volatile compounds
LBXV2C	volatile compounds
LBXV2T	volatile compounds
LBXV3B	volatile compounds
LBXV4A	volatile compounds
LBXV4C	volatile compounds
LBXV4T	volatile compounds
LBXVBF	volatile compounds
LBXVBM	volatile compounds
LBXVBZ	volatile compounds
LBXVCB	volatile compounds
LBXVCF	volatile compounds
LBXVCM	volatile compounds
LBXVCT	volatile compounds
LBXVDB	volatile compounds
LBXVDM	volatile compounds
LBXVDP	volatile compounds
LBXVEB	volatile compounds
LBXVHE	volatile compounds
LBXVMC	volatile compounds
LBXVME	volatile compounds
LBXVOX	volatile compounds
LBXVST	volatile compounds
LBXVTC	volatile compounds
LBXV3A	volatile compounds
LBXVTO	volatile compounds
LBXVXY	volatile compounds
LBX2DF	volatile compounds
LBXV2P	volatile compounds
LBXVNB	volatile compounds
URXUCL	bacterial infection
URXUGC	bacterial infection
LBXBCD	heavy metals
LBXBPB	heavy metals
LBXTHG	heavy metals
LBXIHG	heavy metals
LBXCOT	cotinine
URXUBA	heavy metals
URXUBE	heavy metals
URXUCD	heavy metals
URXUCO	heavy metals
URXUCS	heavy metals
URXUMO	heavy metals
URXUPB	heavy metals
URXUPT	heavy metals
URXUSB	heavy metals
URXUTL	heavy metals
URXUTU	heavy metals
URXUUR	heavy metals
LBXHCY	biochemistry
LBXMMA	biochemistry
LBXRBF	nutrients
LBXB12	nutrients
LBXFOL	nutrients
LBXTFR	biochemistry
LBXFER	biochemistry
URXUAS	heavy metals
URXUAS3	heavy metals
URXUAS5	heavy metals
URXUAB	heavy metals
URXUAC	heavy metals
URXUDMA	heavy metals
URXUMMA	heavy metals
URXUTM	heavy metals
URXUHG	heavy metals
URXUIO	heavy metals
LBXVID	nutrients
LBXVIC	nutrients
LBXGH	biochemistry
LBXGLU	biochemistry
LBXCPSI	biochemistry
LBXIN	hormone
LBXCRP	biochemistry
LBXBAP	biochemistry
LBXPT21	hormone
LBXP1	biochemistry
LBXP2	biochemistry
LBDP3	biochemistry
LBXTC	biochemistry
LBDHDD	biochemistry
LBXTR	biochemistry
LBDLDL	biochemistry
URXUCRSI	biochemistry
URXUMA	biochemistry
URXUMASI	biochemistry
LBXTO1	bacterial infection
LBXTO2	bacterial infection
LBXME	bacterial infection
LBDRUIU	bacterial infection
LBXVAR	bacterial infection
LBXDFS	heavy metals
LBXDFSF	heavy metals
LBDDWS	heavy metals
URXBPH	phenols
URXBP3	phenols
URX4TO	phenols
URXTRS	pesticides
LBXPFOA	polyflourochemicals
LBXPFOS	polyflourochemicals
LBXPFHS	polyflourochemicals
LBXEPAH	polyflourochemicals
LBXMPAH	polyflourochemicals
LBXPFDE	polyflourochemicals
LBXPFBS	polyflourochemicals
LBXPFHP	polyflourochemicals
LBXPFNA	polyflourochemicals
LBXPFSA	polyflourochemicals
LBXPFUA	polyflourochemicals
LBXPFDO	polyflourochemicals
URXMBP	phthalates
URXMCP	phthalates
URXMEP	phthalates
URXMHP	phthalates
URXMNP	phthalates
URXMOP	phthalates
URXMZP	phthalates
URXMNM	phthalates
URXMC1	phthalates
URXMHH	phthalates
URXMOH	phthalates
URXMIB	phthalates
URXECP	phthalates
LBXWBCSI	blood
LBXLYPCT	blood
LBXMOPCT	blood
LBXNEPCT	blood
LBXEOPCT	blood
LBXBAPCT	blood
LBDLYMNO	blood
LBDMONO	blood
LBDNENO	blood
LBDEONO	blood
LBDBANO	blood
LBXRBCSI	blood
LBXHGB	blood
LBXHCT	blood
LBXMCVSI	blood
LBXMCHSI	blood
LBXMC	blood
LBXRDW	blood
LBXPLTSI	blood
LBXMPSI	blood
URXOP1	diakyl
URXOP2	diakyl
URXOP3	diakyl
URXOP4	diakyl
URXOP5	diakyl
URXOP6	diakyl
CFDRIGHT	cognitive functioning
LBX028	pcbs
LBX066	pcbs
LBX074	pcbs
LBX105	pcbs
LBX118	pcbs
LBX156	pcbs
LBX157	pcbs
LBX167	pcbs
LBX189	pcbs
LBXD01	dioxins
LBXD02	dioxins
LBXD03	dioxins
LBXD04	dioxins
LBXD05	dioxins
LBXD07	dioxins
LBXF01	furans
LBXF02	furans
LBXF03	furans
LBXF04	furans
LBXF05	furans
LBXF06	furans
LBXF07	furans
LBXF08	furans
LBXF09	furans
LBXF10	furans
LBXPCB	pcbs
LBXTC2	pcbs
LBXHXC	pcbs
LBXTCD	dioxins
LBX044	pcbs
LBX049	pcbs
LBX052	pcbs
LBX087	pcbs
LBX099	pcbs
LBX101	pcbs
LBX110	pcbs
LBX128	pcbs
LBX138	pcbs
LBX146	pcbs
LBX149	pcbs
LBX151	pcbs
LBX153	pcbs
LBX170	pcbs
LBX172	pcbs
LBX177	pcbs
LBX178	pcbs
LBX180	pcbs
LBX183	pcbs
LBX187	pcbs
LBX194	pcbs
LBX195	pcbs
LBX196	pcbs
LBD199	pcbs
LBX206	pcbs
LBX209	pcbs
LBXHCB	pesticides
LBXBHC	pesticides
LBXGHC	pesticides
LBXPDE	pesticides
LBXPDT	pesticides
LBXODT	pesticides
LBXOXY	pesticides
LBXTNA	pesticides
LBXHPE	pesticides
LBXMIR	pesticides
LBXALD	pesticides
LBXDIE	pesticides
LBXEND	pesticides
LBXBB1	polybrominated ethers
LBXBR1	polybrominated ethers
LBXBR2	polybrominated ethers
LBXBR3	polybrominated ethers
LBXBR4	polybrominated ethers
LBXBR5	polybrominated ethers
LBXBR6	polybrominated ethers
LBXBR7	polybrominated ethers
LBXBR8	polybrominated ethers
LBXBR9	polybrominated ethers
LBXBR66	polybrominated ethers
LBXBR66L	polybrominated ethers
URXP01	hydrocarbons
URXP02	hydrocarbons
URXP03	hydrocarbons
URXP04	hydrocarbons
URXP05	hydrocarbons
URXP06	hydrocarbons
URXP07	hydrocarbons
URXP08	hydrocarbons
URXP10	hydrocarbons
URXP11	hydrocarbons
URXP12	hydrocarbons
URXP13	hydrocarbons
URXP14	hydrocarbons
URXP15	hydrocarbons
URXP16	hydrocarbons
URXP17	hydrocarbons
URXP19	hydrocarbons
URXP20	hydrocarbons
URXP21	hydrocarbons
URXP22	hydrocarbons
URXP24	hydrocarbons
CFDFINSH	cognitive functioning
LBXTV	bacterial infection
LBXBV	bacterial infection
LBXMS1	bacterial infection
LBXM1	bacterial infection
LBXMT1	bacterial infection
LBXMZ1	bacterial infection
LBXMC1	bacterial infection
LBXME1	bacterial infection
LBXMP1	bacterial infection
LBXMO1	bacterial infection
LBXMG1	bacterial infection
LBXML1	bacterial infection
LBXMR1	bacterial infection
LBXCD1	bacterial infection
LBXCH1	bacterial infection
LBXDY1	bacterial infection
LBXETA	bacterial infection
LBXETB	bacterial infection
LBXETC	bacterial infection
LBXETD	bacterial infection
LBXETH	bacterial infection
LBXTSS	bacterial infection
LBXPVL	bacterial infection
LBXSY1	bacterial infection
LBDSY3	bacterial infection
LBDSY4	bacterial infection
LBXEPP	biochemistry
LBXSEL	nutrients
LBXSAL	biochemistry
LBXSATSI	biochemistry
LBXSASSI	biochemistry
LBXSAPSI	biochemistry
LBXSBU	biochemistry
LBXSCA	biochemistry
LBXSCH	biochemistry
LBXSC3SI	biochemistry
LBXSGTSI	biochemistry
LBXSGL	biochemistry
LBXSIR	biochemistry
LBXSLDSI	hormone
LBXSPH	biochemistry
LBXSTB	biochemistry
LBXSTP	biochemistry
LBXSTR	biochemistry
LBXSUA	biochemistry
LBXSCRINV	biochemistry
LBXSNASI	biochemistry
LBXSKSI	biochemistry
LBXSCLSI	biochemistry
LBXSOSSI	biochemistry
LBXSGB	biochemistry
LBXIRN	nutrients
LBXTIB	biochemistry
LBDPCT	biochemistry
LBXVB6	nutrients
LBXVIE	nutrients
LBDATCSI	nutrients
LBXALC	nutrients
LBXACY	nutrients
LBXBEC	nutrients
LBXBCC	nutrients
LBXCBC	nutrients
LBXCLC	nutrients
LBXCLZ	nutrients
LBXCRY	nutrients
LBXDTC	nutrients
LBXGTC	nutrients
LBXLCC	nutrients
LBXLUT	nutrients
LBXLUZ	nutrients
LBXLYC	nutrients
LBXPHF	nutrients
LBXPHE	nutrients
LBXRPL	nutrients
LBXRST	nutrients
LBXVIA	nutrients
LBXZEA	nutrients
LBXIGE	allergen test
LBXID2	allergen test
LBXID1	allergen test
LBXIE1	allergen test
LBXIE5	allergen test
LBXII6	allergen test
LBXIM6	allergen test
LBXF13	allergen test
LBXIF1	allergen test
LBXIF2	allergen test
LBXIW1	allergen test
LBXIG5	allergen test
LBXIG2	allergen test
LBXIT7	allergen test
LBXIT3	allergen test
LBXF24	allergen test
LBXIM3	allergen test
LBXW11	allergen test
LBXE72	allergen test
LBXE74	allergen test
URXUMS	biochemistry
URXUCR	biochemistry
URXCRS	biochemistry
PHAFSTHR	biochemistry
PHAFSTMN	biochemistry
LBXGLT	biochemistry
LBXAPB	biochemistry
URXCCC	pesticides
LBXGLUSI	biochemistry
LBXINSI	hormone
LBXFB	biochemistry
URXNT	biochemistry
LBDHDL	biochemistry
LBXTO3	bacterial infection
LBXTO5	bacterial infection
URX14D	pesticides
URX1TB	pesticides
URX24D	pesticides
URX25T	pesticides
URX3TB	pesticides
URXATZ	pesticides
URXCBF	pesticides
URXDEE	pesticides
URXCPM	pesticides
URXDIZ	pesticides
URXPAR	pesticides
URXPCP	pesticides
URXPPX	pesticides
URXOPP	pesticides
URX4FP	pesticides
URXCB3	pesticides
URXCMH	pesticides
URXDPY	pesticides
URXMET	pesticides
URXOPM	diakyl
URXTCC	pesticides
URXACE	pesticides
LBXMI1	bacterial infection
LBXMF1	bacterial infection
LBXMD1	bacterial infection
LBXMY1	bacterial infection
LBXFSH	hormone
LBXLH	hormone
LBXT4	hormone
LBXTSH	hormone
URXDAZ	phytoestrogens
URXDMA	phytoestrogens
URXEQU	phytoestrogens
URXETD	phytoestrogens
URXETL	phytoestrogens
URXGNS	phytoestrogens
URXP09	hydrocarbons
URXP18	hydrocarbons
URXMAL	pesticides
HRDHG	heavy metals
HRXHG	heavy metals
LBXZMB	volatile compounds
LBXZDB	volatile compounds
LBXZXY	volatile compounds
LBXZOX	volatile compounds
LBXZTI	volatile compounds
LBXZTO	volatile compounds
LBXZTE	volatile compounds
LBXZEB	volatile compounds
LBXZCF	volatile compounds
LBXZBZ	volatile compounds
LBDC2	bacterial infection
LBDC1	bacterial infection
LBXHP1	bacterial infection
LBXWIO	perchlorate
LBXWNO	perchlorate
LBXWP8	perchlorate
LBDTLY	nutrients
URXDCB	pesticides
URXBUP	phenols
URXEPB	phenols
URXMPB	phenols
URXPPB	phenols
SSMEL	melamine
LBXACR	acrylamide
LBXGLY	acrylamide
URXAAZ	pesticides
URXAPE	pesticides
URXDAM	pesticides
URXDCZ	pesticides
URXDTZ	pesticides
URXETU	pesticides
URXMMI	pesticides
URXMTO	pesticides
URXOMO	pesticides
URXPTU	pesticides
URXSIS	pesticides
drink_five_per_day	alcohol use
quantity_drink_per_day	alcohol use
total_days_5drink_year	alcohol use
total_days_drink_year	alcohol use
DUQ100	street drug
DUQ110	street drug
DUQ120	street drug
DUQ130	street drug
DUQ200	street drug
DUQ210	street drug
DUQ230	street drug
DUQ240	street drug
DUQ250	street drug
DUQ260	street drug
DUQ272	street drug
DUQ280	street drug
DUQ290	street drug
DUQ300	street drug
DUQ320	street drug
DUQ330	street drug
DUQ340	street drug
DUQ352	street drug
DUQ360	street drug
DUQ370	street drug
last_time_used_cocaine	street drug
last_time_used_heroin	street drug
last_time_used_marijuana	street drug
last_time_used_meth	street drug
SMD450	smoking family
SMD440	smoking family
SMD430	smoking family
SMD415C	smoking family
SMD415B	smoking family
SMD415A	smoking family
SMD415	smoking family
SMD410	smoking family
DED038Q	sun exposure
hepa	immunization
hepb	immunization
pneu	immunization
current_loud_noise	occupation
ever_loud_noise_gt3	occupation
ever_loud_noise_gt3_2	occupation
industry_agriculture	occupation
industry_construction	occupation
industry_manufacturing	occupation
industry_mining	occupation
industry_other	occupation
industry_transport	occupation
num_months_longest_job	occupation
num_months_main_job	occupation
occupation_construction	occupation
occupation_farm	occupation
occupation_household	occupation
occupation_laborer	occupation
occupation_midmanage	occupation
occupation_military	occupation
occupation_repair	occupation
occupation_transport	occupation
smell_tobacco	occupation
SMD650	smoking behavior
SMD641	smoking behavior
SMQ077	smoking behavior
SMQ230	smoking behavior
SMQ210	smoking behavior
SMQ180	smoking behavior
SMQ150	smoking behavior
SMQ120	smoking behavior
SMQ050	smoking behavior
SMQ040	smoking behavior
SMQ020	smoking behavior
SMD235	smoking behavior
SMD220	smoking behavior
SMD190	smoking behavior
SMD160	smoking behavior
SMD130	smoking behavior
SMD100TR	smoking behavior
SMD100NI	smoking behavior
SMD100MN	smoking behavior
SMD100FL	smoking behavior
SMD100CO	smoking behavior
SMD090	smoking behavior
SMD080	smoking behavior
SMD075	smoking behavior
SMD070	smoking behavior
SMD057	smoking behavior
SMD055	smoking behavior
SMD030	smoking behavior
anyone_to_help_social	social support
first_degree_support	social support
number_close_friends	social support
SXQ020	sexual behavior
SXQ270	bacterial infection
SXQ280	sexual behavior
TBQ020	bacterial infection
TBQ030	bacterial infection
TBQ040	bacterial infection
TBQ050	bacterial infection
TBQ060	bacterial infection
DR1TALCO	food component recall
DR1TCAFF	food component recall
DR1TCALC	food component recall
DR1TCARB	food component recall
DR1TCARO	food component recall
DR1TCHOL	food component recall
DR1TCOPP	food component recall
DR1TFIBE	food component recall
DR1TIRON	food component recall
DR1TKCAL	food component recall
DR1TM161	food component recall
DR1TM181	food component recall
DR1TM201	food component recall
DR1TM221	food component recall
DR1TMAGN	food component recall
DR1TMFAT	food component recall
DR1TNIAC	food component recall
DR1TP182	food component recall
DR1TP183	food component recall
DR1TP184	food component recall
DR1TP204	food component recall
DR1TP205	food component recall
DR1TP225	food component recall
DR1TP226	food component recall
DR1TPFAT	food component recall
DR1TPHOS	food component recall
DR1TPOTA	food component recall
DR1TPROT	food component recall
DR1TS040	food component recall
DR1TS060	food component recall
DR1TS080	food component recall
DR1TS100	food component recall
DR1TS120	food component recall
DR1TS140	food component recall
DR1TS160	food component recall
DR1TS180	food component recall
DR1TSELE	food component recall
DR1TSFAT	food component recall
DR1TTFAT	food component recall
DR1TTHEO	food component recall
DR1TVAIU	food component recall
DR1TVARE	food component recall
DR1TVB1	food component recall
DR1TVB12	food component recall
DR1TVB2	food component recall
DR1TVB6	food component recall
DR1TVC	food component recall
DR1TVE	food component recall
DR1TWATE	food component recall
DR1TZINC	food component recall
DRD320GW	food component recall
DRD330GW	food component recall
DRD340	food component recall
DRD350A	food component recall
DRD350AQ	food component recall
DRD350B	food component recall
DRD350BQ	food component recall
DRD350C	food component recall
DRD350CQ	food component recall
DRD350D	food component recall
DRD350DQ	food component recall
DRD350E	food component recall
DRD350EQ	food component recall
DRD350F	food component recall
DRD350FQ	food component recall
DRD350G	food component recall
DRD350GQ	food component recall
DRD350H	food component recall
DRD350HQ	food component recall
DRD350I	food component recall
DRD350IQ	food component recall
DRD350J	food component recall
DRD350JQ	food component recall
DRD350K	food component recall
DRD360	food component recall
DRD370A	food component recall
DRD370AQ	food component recall
DRD370B	food component recall
DRD370BQ	food component recall
DRD370C	food component recall
DRD370CQ	food component recall
DRD370D	food component recall
DRD370DQ	food component recall
DRD370E	food component recall
DRD370EQ	food component recall
DRD370F	food component recall
DRD370FQ	food component recall
DRD370G	food component recall
DRD370GQ	food component recall
DRD370H	food component recall
DRD370HQ	food component recall
DRD370I	food component recall
DRD370IQ	food component recall
DRD370J	food component recall
DRD370JQ	food component recall
DRD370K	food component recall
DRD370KQ	food component recall
DRD370L	food component recall
DRD370LQ	food component recall
DRD370M	food component recall
DRD370MQ	food component recall
DRD370N	food component recall
DRD370NQ	food component recall
DRD370O	food component recall
DRD370OQ	food component recall
DRD370P	food component recall
DRD370PQ	food component recall
DRD370Q	food component recall
DRD370QQ	food component recall
DRD370R	food component recall
DRD370RQ	food component recall
DRD370S	food component recall
DRD370SQ	food component recall
DRD370T	food component recall
DRD370TQ	food component recall
DRD370U	food component recall
DRD370UQ	food component recall
DRD370V	food component recall
DRDTSODI	food component recall
DBD100	food component recall
DBQ095	food component recall
DR1TACAR	food component recall
DR1TATOC	food component recall
DR1TBCAR	food component recall
DR1TCRYP	food component recall
DR1TFA	food component recall
DR1TFDFE	food component recall
DR1TFF	food component recall
DR1TLYCO	food component recall
DR1TLZ	food component recall
DR1TMOIS	food component recall
DR1TRET	food component recall
DR1TSUGR	food component recall
DR1TVARA	food component recall
DR1TVK	food component recall
DRDCWATR	food component recall
DRDDRSTZ	food component recall
DRDRESP	food component recall
lite_salt	food component recall
no_salt	food component recall
ordinary_salt	food component recall
salt_substitute	food component recall
community_supply	food component recall
DR1_320	food component recall
DR1_330	food component recall
DR1BWATR	food component recall
DR1CWATR	food component recall
DR1TATOA	food component recall
DR1TB12A	food component recall
DR1TSODI	food component recall
DRDSDT1	food component recall
DRDSDT2	food component recall
DRDSDT3	food component recall
DRDSDT4	food component recall
DRDSDT5	food component recall
DRDSDT6	food component recall
DRDSDT7	food component recall
DRDSDT8	food component recall
spring_water	food component recall
well_water	food component recall
DR1_330Z	food component recall
DR1TCHL	food component recall
LBXSCR	biochemistry
BMXWT	body measures
BMXRECUM	body measures
BMXHEAD	body measures
BMXHT	body measures
BMXBMI	body measures
BMXLEG	body measures
BMXCALF	body measures
BMXWAIST	body measures
BMXTHICR	body measures
BMXTRI	body measures
BMXSUB	body measures
BPXCHR	blood pressure
MSYS	blood pressure
MDIS	blood pressure
BPXPLS	blood pressure
supplement_count	supplement use
DSDCOUNT	supplement use
VITAMIN_B_6_mg	supplement use
VITAMIN_B_12_mcg	supplement use
VITAMIN_C_mg	supplement use
VITAMIN_A_IU	supplement use
FOLIC_ACID_mcg	supplement use
OMEGA_6_FATTY_ACIDS_NA	supplement use
OMEGA_3_FATTY_ACIDS_mg	supplement use
OMEGA_9_FATTY_ACIDS_NA	supplement use
OTHER_FATTY_ACIDS_NA	supplement use
OTHER_OMEGA_3_FATTY_ACIDS_NA	supplement use
ALANINE_mg	supplement use
ALCOHOL_PERCENT	supplement use
ARGININE_mg	supplement use
L_ASPARTIC_ACID_mg	supplement use
L_ASPARTIC_ACID_gm	supplement use
BETA_CAROTENE_IU	supplement use
BETA_CAROTENE_mg	supplement use
BETA_CAROTENE_mcg	supplement use
CAFFEINE_mg	supplement use
CALCIUM_mg	supplement use
CALCIUM_PPM	supplement use
CHOLESTEROL_mg	supplement use
COPPER_mg	supplement use
CYSTINE_mg	supplement use
L_GLUTAMINE_mg	supplement use
L_GLUTAMINE_gm	supplement use
GLYCINE_mg	supplement use
GLYCINE_gm	supplement use
HISTIDINE_mg	supplement use
IRON_mg	supplement use
ISOLEUCINE_mg	supplement use
LEUCINE_mg	supplement use
LYSINE_mg	supplement use
MAGNESIUM_mg	supplement use
MAGNESIUM_PPM	supplement use
METHIONINE_mg	supplement use
PHENYLALANINE_mg	supplement use
PHOSPHORUS_mg	supplement use
POTASSIUM_mg	supplement use
PROLINE_mg	supplement use
PROTEIN_gm	supplement use
RIBOFLAVIN_mg	supplement use
SELENIUM_mcg	supplement use
SERINE_mg	supplement use
SODIUM_mg	supplement use
THIAMIN_mg	supplement use
THREONINE_mg	supplement use
ALPHA_TOCOPHEROL_NA	supplement use
TOTAL_CARBOHYDRATE_gm	supplement use
TRYPTOPHAN_mg	supplement use
TYROSINE_mg	supplement use
VALINE_mg	supplement use
VITAMIN_B_6_Unknown	supplement use
VITAMIN_B_12_Unknown	supplement use
VITAMIN_C_Unknown	supplement use
VITAMIN_A_mg	supplement use
VITAMIN_A_Unknown	supplement use
VITAMIN_A_mcg	supplement use
FOLIC_ACID_Unknown	supplement use
OMEGA_3_FATTY_ACIDS_Unknown	supplement use
OTHER_FATTY_ACIDS_mg	supplement use
ARGININE_gm	supplement use
BETA_CAROTENE_Unknown	supplement use
CALCIUM_Trace	supplement use
CALCIUM_Unknown	supplement use
COPPER_Trace	supplement use
COPPER_Unknown	supplement use
IRON_Trace	supplement use
IRON_Unknown	supplement use
MAGNESIUM_Unknown	supplement use
PHOSPHORUS_Trace	supplement use
PHOSPHORUS_Unknown	supplement use
RIBOFLAVIN_Unknown	supplement use
SELENIUM_Trace	supplement use
SELENIUM_Unknown	supplement use
THIAMIN_Unknown	supplement use
ALPHA_TOCOPHEROL_IU	supplement use
OMEGA_6_FATTY_ACIDS_mg	supplement use
OMEGA_9_FATTY_ACIDS_mg	supplement use
BETA_CAROTENE__	supplement use
SODIUM_Trace	supplement use
ALPHA_TOCOPHEROL_mg	supplement use
DIETARY_FIBER_mg	supplement use
URXBSM	pesticides
URXCHS	pesticides
URXEMM	pesticides
URXFRM	pesticides
URXHLS	pesticides
URXMSM	pesticides
URXMTM	pesticides
URXNOS	pesticides
URXOXS	pesticides
URXPIM	pesticides
URXPRO	pesticides
URXRIM	pesticides
URXSMM	pesticides
URXSSF	pesticides
URXTHF	pesticides
URXTRA	pesticides
URXTRN	pesticides
cigarette_smoking	smoking behavior
URXCNP	phthalates
URXCOP	phthalates
URXNO3	perchlorate
URXSCN	perchlorate
LBXV2E	volatile compounds
LBXV4E	volatile compounds
LBXVTE	volatile compounds
any_diabetes	disease
any_ht	disease
cad	disease
bladder_cancer_self_report	disease
blood_cancer_self_report	disease
bone_cancer_self_report	disease
brain_cancer_self_report	disease
breast_cancer_self_report	disease
cervix_cacner_self_report	disease
colon_cancer_self_report	disease
esophagus_cancer_self_report	disease
gallbladder_cancer_self_report	disease
kidney_cancer_self_report	disease
larynx_cancer_self_report	disease
leukemia_self_report	disease
liver_cancer_self_report	disease
lung_cancer_self_report	disease
lymphoma_self_report	disease
melanoma_self_report	disease
mouth_cancer_self_report	disease
nervous_cancer_self_report	disease
ovarian_cancer_self_report	disease
pancreatic_cancer_self_report	disease
prostate_cancer_self_report	disease
rectum_cancer_self_report	disease
skin_cancer_self_report	disease
other_skin_cancer_self_report	disease
soft_cancer_self_report	disease
stomach_cancer_self_report	disease
testis_cancer_self_report	disease
thyroid_cancer_self_report	disease
uterine_cancer_self_report	disease
other_cancer_self_report	disease
any_cancer_self_report	disease
any_family_cad	disease
current_past_smoking	smoking behavior
occupation	occupation
DXXLSBMD	body measures
DXXPEBMD	body measures
DXXHEBMD	body measures
DXDTRLE	body measures
DXXTRFAT	body measures
DXDTOLE	body measures
DXDTOFAT	body measures
DXDTOBMD	body measures
current_asthma	disease
ever_asthma	disease
ever_arthritis	disease
ever_rheumatoid_arthritis	disease
ever_osteo_arthritis	disease
TELOMEAN	aging
taking_birth_control	reproductive health
age_stopped_birth_control	reproductive health